C 2 31,112,98
F 255, 255 ,255

1111111111111111111111111
1000000000110000000000001
1011000001110000002000001
100100000000000000000000111111111
111111111011000001110000000000001
100000000011000001110111111111111
11110111111111011100000010001
11110111111111011101010010001
11000000110101011100000010001
10002000000000001100000010001
10000000000000001101010010001
11000001110101011111011110N0111
11110111 1110101 101111010001
11111111 1111111 111111111111

1111  1111111111111111111
10S1  1002000002000000001
1001  1000001111110000211111111111
1021  10000001   11000000000000001
10011111110001    1111111110010201
12000000000021            10200001
11111111111111            10020001
                          11111111

1111111111
1002222001
1002E00001
1002220001
1000000001
1111111111

1111  111111111111111111
10S1  120000000000000001
1001  1000111111110000211111111111
1001  10000001   10000000000000001
10011111110001   11111111110000001
12000000000021            10200201
11111111111111            10022001
                          11111111